Субъект РФ;Самостоятельные образовательные организации, всего;Самостоятельные образовательные организации, государственные и муниципальные;Самостоятельные образовательные организаци, частные;Филиалы самостоятельных образовательных организаций, всего;Филиалы самостоятельных образовательных организаций, государственные и муниципальные;Филиалы самостоятельных образовательных организаций, частные;Численность студентов, всего человек;Численность работников, всего человек;Профессорско-преподавательский состав, всего человек;Год формирования сведений
Российская Федерация;710;497;213;549;430;119;4049333;576276;223088;2020
Центральный федеральный округ;258;154;104;128;89;39;1284407;198727;75141;2020
   Белгородская область;5;4;1;6;5;1;46181;5562;2275;2020
   Брянская область;5;4;1;5;5;0;22876;2435;990;2020
   Владимирская область;3;2;1;6;5;1;25377;2617;1153;2020
   Воронежская область;15;10;5;9;7;2;84976;9906;4594;2020
   Ивановская область;6;6;0;5;3;2;24274;3765;1543;2020
   Калужская область;3;1;2;8;7;1;19198;1741;834;2020
   Костромская область;2;2;0;0;0;0;9998;1251;548;2020
   Курская область;8;5;3;3;1;2;37036;4125;1717;2020
   Липецкая область;4;3;1;7;3;4;19439;1849;935;2020
   Московская область;24;13;11;36;25;11;78707;10857;3806;2020
   Орловская область;4;4;0;5;4;1;27437;2996;1308;2020
   Рязанская область;6;4;2;3;1;2;29673;3888;1667;2020
   Смоленская область;6;5;1;10;6;4;21573;2894;1270;2020
   Тамбовская область;4;4;0;3;2;1;27784;3685;1350;2020
   Тверская область;6;4;2;3;2;1;22682;3369;1475;2020
   Тульская область;5;2;3;6;5;1;33403;3327;1267;2020
   Ярославская область;8;7;1;7;5;2;31304;4101;1785;2020
   г.Москва;144;74;70;6;3;3;722489;130359;46624;2020
Северо-Западный федеральный округ;87;59;28;42;32;10;424214;71689;26863;2020
   Республика Карелия;2;2;0;2;2;0;10769;1917;736;2020
   Республика Коми;3;3;0;3;3;0;13837;1686;547;2020
   Архангельская область;4;2;2;3;2;1;17287;2670;987;2020
   Вологодская область;4;4;0;3;2;1;18653;1893;757;2020
   Калининградская область;3;2;1;6;2;4;20505;3017;1076;2020
   Ленинградская область;1;1;0;9;8;1;6290;637;242;2020
   Мурманская область;4;3;1;4;3;1;6564;1017;358;2020
   Новгородская область;1;1;0;1;1;0;8454;1300;455;2020
   Псковская область;3;3;0;5;3;2;11383;1363;544;2020
   г.Санкт-Петербург;62;38;24;6;6;0;310472;56189;21161;2020
   Ненецкий автономный округ;0;0;0;0;0;0;0;0;0;2020
Южный федеральный округ;58;40;18;83;69;14;395814;51487;21029;2020
   Республика Адыгея;2;2;0;1;1;0;14219;1274;622;2020
   Республика Калмыкия;1;1;0;1;0;1;8886;815;380;2020
   Краснодарский край;17;10;7;26;23;3;104878;12055;4901;2020
   Астраханская область;6;5;1;7;5;2;29329;3836;1569;2020
   Волгоградская область;12;9;3;12;8;4;57763;7770;3300;2020
   Ростовская область;12;8;4;25;22;3;132256;17812;6957;2020
   г.Севастополь;7;4;3;6;6;0;34365;6054;2507;2020
   Республика Крым;1;1;0;5;4;1;14118;1871;793;2020
Северо-Кавказский федеральный округ;40;26;14;40;33;7;206103;22935;10210;2020
   Республика Дагестан;12;6;6;16;15;1;50481;5630;2730;2020
   Республика Ингушетия;2;1;1;0;0;0;7871;817;301;2020
   Кабардино-Балкарская Республика;3;3;0;0;0;0;15214;2207;830;2020
   Карачаево-Черкесская Республика;2;2;0;3;1;2;11200;1291;539;2020
   Республика Северная Осетия - Алания;6;5;1;1;1;0;20786;3011;1372;2020
   Чеченская Республика;3;3;0;1;0;1;34006;2105;1070;2020
   Ставропольский край;12;6;6;19;16;3;66545;7874;3368;2020
Приволжский федеральный округ;111;87;24;125;99;26;798245;101390;40369;2020
   Республика Башкортостан;10;8;2;18;16;2;97299;10735;4811;2020
   Республика Марий Эл;3;2;1;0;0;0;16426;2145;866;2020
   Республика Мордовия;2;2;0;3;2;1;24556;3012;1416;2020
   Республика Татарстан;21;13;8;19;12;7;142005;19525;7178;2020
   Удмуртская Республика;7;5;2;8;7;1;42463;4781;1899;2020
   Чувашская Республика;4;4;0;6;4;2;34387;2991;1303;2020
   Пермский край;10;8;2;12;11;1;54486;8467;3103;2020
   Кировская область;4;3;1;5;2;3;27921;2897;1157;2020
   Нижегородская область;10;10;0;17;15;2;83454;11673;4644;2020
   Оренбургская область;6;5;1;11;9;2;42465;4396;1986;2020
   Пензенская область;5;4;1;3;2;1;31956;3419;1649;2020
   Самарская область;17;12;5;6;5;1;94803;12345;4811;2020
   Саратовская область;7;6;1;11;9;2;70867;9745;3910;2020
   Ульяновская область;5;5;0;6;5;1;35157;5259;1636;2020
Уральский федеральный округ;47;37;10;47;39;8;290923;37934;14535;2020
   Курганская область;3;3;0;3;2;1;14691;1417;573;2020
   Свердловская область;22;14;8;16;15;1;119366;15247;6154;2020
   Тюменская область;5;5;0;6;4;2;50426;6406;2338;2020
   Челябинская область;12;10;2;16;14;2;84536;12158;4447;2020
   Ханты-Мансийский автономный округ;5;5;0;4;3;1;21517;2678;1011;2020
   Ямало-Ненецкий автономный округ;0;0;0;2;1;1;387;28;12;2020
Сибирский федеральный округ;70;59;11;50;42;8;471585;65150;25042;2020
   Республика Алтай;1;1;0;0;0;0;2647;328;165;2020
   Республика Тыва;1;1;0;1;0;1;5198;615;279;2020
   Республика Хакасия;1;1;0;2;2;0;8013;1115;386;2020
   Алтайский край;7;7;0;10;8;2;49608;5903;2399;2020
   Красноярский край;8;7;1;8;4;4;66534;11564;4486;2020
   Иркутская область;10;8;2;8;8;0;65930;8341;3253;2020
   Кемеровская область;7;6;1;8;8;0;45006;4655;2150;2020
   Новосибирская область;16;14;2;4;4;0;97585;12105;5119;2020
   Омская область;12;8;4;6;5;1;73370;7999;3143;2020
   Томская область;7;6;1;3;3;0;57694;12525;3662;2020
Дальневосточный федеральный округ;39;35;4;34;27;7;178042;26964;9899;2020
   Республика Бурятия;5;4;1;2;1;1;20021;2676;1244;2020
   Республика Саха (Якутия);7;5;2;8;4;4;23738;3798;1532;2020
   Забайкальский край;2;2;0;4;3;1;21487;2494;1015;2020
   Камчатский край;2;2;0;3;2;1;4383;462;158;2020
   Приморский край;8;7;1;8;8;0;43152;9809;2789;2020
   Хабаровский край;8;8;0;5;5;0;40641;4911;2088;2020
   Амурская область;4;4;0;2;2;0;14446;1925;747;2020
   Магаданская область;1;1;0;0;0;0;2579;221;102;2020
   Сахалинская область;1;1;0;1;1;0;5509;470;152;2020
   Еврейская автономная область;1;1;0;0;0;0;1947;183;68;2020
   Чукотский автономный округ;0;0;0;1;1;0;139;15;4;2020
